######################
#@....................
#.....................
#.....................
################......
#..............#......
#..............#......
#..............#......
#......O.......#......
#..............#......
#..............#......
#..............#......
#..............#......
#..............#......
#..............########
#......................
#......................
#......................
#......................
#.....................>
######################
