############
#@.........#
#..........#
#..........#
#..........#
#..........#
#..........#
#..........#
###.......##
#.O.......##
#.........##
#.........>#
############
