####################
#@.................#
#..................#
#..................#
#..................#
#.....T............#
#..................#
#..................#
#..................#
#########..........#
#..................#
#..................#
#..................#
#..................#
#..................#
#..................#
#..................#
#..................>
####################
