######
#@...#
####.#
####O#
####>#
######