################
#.............>#
#####.##########
    #O#
#####.#####
#@........#
###########