#########
#@......#
#######.#
#######.#
#######.#
#>......#
#########