#########
#@.#....#
#..#....#
#..#..#.#
#.....#.#
####..#.#
#.....#.#
#..#..#.#
#......>#
#########