###########
#@........#
#...###...#
#...###...#
#...###...#
#........>#
###########