#######
#@....#
#####.#
#####.#
#.....#
#.#####
#.#####
#....>#
#######