#########
#@......#
#######.#
#######.#
#>......#
#######.#
#######.#
#########