########
#@.....#
######.#
#....#.#
#..>.#.#
#.####.#
#......#
########