#############
#@..........#
###.###.###.#
#...#...#...#
#.###.###.###
#...........#
#####.>.#####
#############