############
#@.........#
#..#...#...#
#....#...#.#
#.#....#...#
#...#....#.#
#.....>....#
############