#########
#@......#
###.###.#
#.....#.#
#.#.#.#.#
#.#...#.#
#.#.###.#
#.......#
####...>#
#########