####################
#@.................#
#..................#
#..................#
#......O...........#
#..................#
#..................#
#..................#
#.................>#
####################