################
#@.............#
#..............#
#..............#
#..............#
#.......O......#
#..............#
#..............#
###########....#
#..............#
#..............#
#..............#
#..............>
################
