15x15_empty_room.txt
---
#################
#...............#
#...............#
#...............#
#...............#
#...............#
#.......>.......#
#...............#
#...............#
#...............#
#...............#
#...............#
#...............#
#@..............#
#################
---

30x30_empty_room.txt
---
################################
#@.............................#
#..............................#
#..............................#
#..............................#
#..............................#
#..............................#
#..............................#
#..............................#
#..............................#
#..............................#
#..............................#
#..............................#
#..............................#
#...............>..............#
#..............................#
#..............................#
#..............................#
#..............................#
#..............................#
#..............................#
#..............................#
#..............................#
#..............................#
#..............................#
#..............................#
#..............................#
#..............................#
#..............................#
################################
---

5x5_empty_room.txt
---
#######
#.....#
#..>..#
#....@#
#######
---

single_turn_15.txt
---
###########
#@#########
#.#########
#.#########
#.#########
#.#########
#.#########
#.#########
#........>#
###########
---

single_turn_20.txt
---
#############
###########>#
###########.#
###########.#
###########.#
###########.#
###########.#
###########.#
###########.#
###########.#
###########.#
#@..........#
#############
---

single_turn_5.txt
---
#####
#@..#
###.#
###>#
#####
---

straight_corridor_15.txt
---
#################
#@.............>#
#################
---

straight_corridor_25.txt
---
###########################
#@.......................>#
###########################
---

straight_corridor_5.txt
---
#######
#@...>#
#######
---

t_junction_10.txt
---
############
#.........>#
######.#####
######.#####
######.#####
######.#####
#@.........#
############
---

t_junction_15.txt
---
#################
#..............>#
######.##########
######.##########
######.##########
######.##########
#@..............#
#################
---

t_junction_5.txt
---
#######
#....>#
###.###
###.###
#@....#
#######
---
