###############
#.............#
#.###.###.###.#
#.#.#.#.#.#.#.#
#.#...#.#...#.#
#.#.###.###.#.#
#.#.........#.#
#.#....@....#.#
#.#.........#.#
#.#.###.###.#.#
#.#...#.#...#.#
#.#.#.#.#.#.#.#
#.###.###.###.#
#............>#
###############