#########
#@#####>#
#..###..#
#...#...#
#.......#
#.......#
#########