####################
#@.................#
#.########.#######.#
#.#......#.#.....#.#
#.#.####.#.#.###.#.#
#...##...#...#...#.#
#...##...#...#...#.#
#.#.##.#.#.###.#.#.#
#...##...#...#...#>#
####################