####################
#@.................#
#.########.#######.#
#.#......#.#.....#.#
#.#.####.#.#.###.#.#
#.#....#.#...#...#.#
#.####.#.#####.###.#
#......#.......#...#
#.######.#######.#.#
#.#....#.#.....#.#.#
#.#.##.#.#.###.#.#.#
#...##...#...#...#>#
####################