################
#@.#...........#
#..#.#########.#
#..#.#.......#.#
#..#.#.#####.#.#
#..#...#...#.#.#
#..#####.#.#.#.#
#........#...#>#
################