#################
#...............#
#...............#
#...............#
#...............#
#...............#
#.......>.......#
#...............#
#...............#
#...............#
#...............#
#...............#
#...............#
#@..............#
#################