#######
#.....#
#..>..#
#....@#
#######