##########
#@.......#
#........#
#........#
#........#
#........#
#.......>#
##########