#################
#..............@#
#...............#
#...............#
#>..............#
#################