######
#....#
#.@..#
#..>.#
#....#
######