#######
#.....#
#..>..#
#.....#
#.....#
#.....#
#.....#
#.....#
#.....#
#.....#
#..@..#
#.....#
#######