####################
#@.................#
#..................#
#..................#
#..................#
#..................#
#......OOO.........#
#......OOO.........#
#......OOO.........#
#..................#
#..................#
##########.........#
#..................#
#..................#
#..................#
#..................>
####################
