#############
#@..........#
#...O.......#
#......O....#
#...........#
#.....O.....#
#..........>#
#############