####################
#@.................#
#..................#
#..................#
#......O...........#
#..................#
#..................#
#..................#
##########.........#
#.................>#
####################
