#############
#@..........#
#...........#
#.....O.....#
#..........>#
#############