##############
#@.....#.....#
#..#......#..#
#..#......#..#
#..#...#.....#
#......#.....#
#.....>#.....#
#............#
#..#...#.....#
##############