########
#@.O...#
#......#
#......#
#......#
#......>
########
