############
#@.........#
#..........#
#..........#
#..........#
#..........#
#.....O....#
#..........#
#..........#
#..........>
############
