############
#@.........#
#..........#
#..........#
#..........#
#..........#
#..........#
#.........O>
############
