####################
#@.................#
#..................#
#..................#
#..................#
#..................#
#..................#
#........O.........#
#..................#
#..................#
#..................#
#..................#
#..................#
#..................#
#..................#
#..................#
#..................#
#..................#
#..............#...#
#..............#..>#
####################
