########################
#@.....................#
#......................#
#......................#
#......................#
#.....O................#
#......................#
#......................#
#......................#
#......................#
#................O.....#
#......................#
#......................#
#......................#
#......................#
#......................#
#........O.............#
#......................#
#......................#
#......................#
#......................#
#......................#
#......................>
########################
