################
#@.............#
#..............#
#..............#
#..............#
#..............#
#..............#
#..............#
#..............#
#..........T...#
#..............#
#..............>
################
