######
#@...#
####.#
####.#
####>#
######