################
#.............>#
#####.##########
#####.#####
#####.#####
#####.#####
#####.#####
#@........#
###########
