####################
#@.................#
#..................#
#..................#
#..................#
#.......O..........#
#..................#
#..................#
#..................#
##########.........#
#.................##
#.........O.......##
#.................##
#.................>#
####################
