###########
#@#########
#.#########
#.#########
#.#########
#.#########
#.#########
#.#########
#........>#
###########