#############
###########>#
###########.#
###########.#
###########.#
###########.#
###########.#
###########.#
###########.#
###########.#
###########.#
#@..........#
#############