############
#.........>#
######.#####
######.#####
######.#####
######.#####
#@.........#
############