#################
#..............>#
######.##########
######.##########
######.##########
######.##########
#@..............#
#################