#######
#....>#
###.###
###.###
#@....#
#######